0 0 1 0 0 1 1 0 1 1 0
0 0 1 0 1 0 0 0 0 0 0
0 2 1 2 2 2 3 2 3 2 2
0 0 3 4 3 1 3 2 1 1 2
1 2 1 -1 0 0 -1 0 0 1 0
1 2 2 0 1 2 -3 -2 2 1 2
0 2 4 3 3 3 1 2 5 3 5
1 2 -7 -9 -7 -8 -12 -9 -6 -7 -7
2 1 6 4 5 5 3 4 5 4 5
0 1 9 7 8 8 5 6 9 8 7