0 0 1 0 0 1 1 0 1 1 0
0 0 1 0 1 0 0 0 0 0 0
0 2 1 2 2 2 3 2 3 2 2
0 0 3 4 3 1 3 2 1 1 2
1 2 1 -1 0 0 -1 0 0 1 0
1 2 2 0 1 2 -3 -2 2 1 2
0 2 4 3 3 3 1 2 5 3 5
1 2 -7 -9 -7 -8 -12 -9 -6 -7 -7
2 1 6 4 5 5 3 4 5 4 5
0 1 9 7 8 8 5 6 9 8 7
2 0 5 4 6 3 0 4 4 4 6
2 1 -1 -4 1 1 0 3 3 3 3
1 2 -4 -5 -4 -5 -6 -4 -8 -9 -5
2 0 7 6 8 8 7 7 9 8 8
1 0 9 11 13 9 11 13 12 12 12
0 1 -5 -3 0 -4 -1 0 -4 -2 0
0 1 2 0 3 0 -4 1 0 1 3
0 2 9 9 10 4 7 10 8 10 11
0 2 -2 -1 1 0 2 2 3 3 3
1 2 -4 -7 -7 -4 -9 -9 -3 -3 -4
2 2 4 1 1 2 -1 -1 2 0 1
2 2 -6 -6 -5 -6 -9 -10 -5 -6 -8
1 2 6 6 4 6 4 1 6 3 2
1 0 6 5 7 5 2 7 5 4 7
2 0 -2 -4 -3 -1 -2 -4 -1 -1 -1
2 1 2 -1 0 1 -3 -1 3 1 1
2 2 -4 -7 -5 -4 -5 -4 -4 -5 -4
1 0 6 7 8 4 6 7 5 7 7
0 1 0 1 4 -2 0 4 1 2 4
2 1 0 -2 0 0 -1 1 -1 -2 -1
2 0 3 -1 -2 3 -1 -3 3 0 -1
1 1 -2 -2 -2 -2 -3 -4 -3 -4 -2
2 1 -3 -7 -7 -3 -7 -8 -2 -2 -4
2 0 6 4 3 3 1 1 3 2 4
2 1 2 3 5 4 6 5 8 8 6
2 1 11 8 9 10 9 11 11 10 11
1 2 4 5 5 0 4 5 1 3 4
2 1 -3 -6 -6 -3 -5 -8 -3 -5 -9
1 1 12 10 12 11 12 13 12 11 12
2 0 11 10 12 10 9 11 11 11 12
0 1 8 7 5 8 5 2 6 5 6
0 0 -5 -4 -5 -7 -4 -7 -6 -4 -4
0 1 -7 -6 -5 -12 -13 -7 -6 -5 -5
1 0 8 8 14 12 10 13 14 13 14
1 0 -1 -1 1 -3 -6 0 -1 -3 1
1 1 6 5 6 5 3 7 6 4 7
2 1 3 2 3 4 1 -2 4 2 -1
2 2 1 1 2 -3 0 2 -2 0 2
2 2 3 1 0 1 1 1 2 2 3
1 2 6 6 5 4 4 3 5 5 5